1111111111111
100000000C001
1000011111001
1P0011E0000Z1
1111111111111
