1111111111111
100000000CZ01
1000011111001
1P0011E000001
1111111111111
